0000011111111111111111111
0000012222222222133333333
0000012222222222133333333
0000012222222222111111111
0000012222222222133333333
1111111111111122133333333
1333333333333122111111111
1333333333333122133333333
1331111111133122122222222
1331333333133122122222222
1331333333133122111111111
1331332222133122155155177
1331331111133122155155177
1331333333333111155155177
1331333333333122155155177
1111111111111122155155111
1222222222212222155155155
1222222222212222111111155
1111111111111111122155177
1331221444415555122155177
1331221444415555122155177
1331221444415555122155177
1331221444415555122111111
1331221444411111111166122
1331221444415555155166122