071171171170
898898898898
171172271171
171172271171
898898898898
172273372271
172273372271
898898898898
171172271171
171172271171
898898898898
071171171170
